PARCEL #,PROPERTY,TOTAL FCV 2024,TOTAL FCV 2025,FCV VARIANCE 2425,LIMTED VALUE 2024,LIMTED VALUE 2025,LPV VARIANCE 2425,TOTAL FCV 2023,TOTAL FCV 2024,FCV VARIANCE 2324,LIMTED VALUE 2023,LIMTED VALUE 2024,LPV VARIANCE 2324,TOTAL FCV 2022,TOTAL FCV 2023,FCV VARIANCE 2223,LIMTED VALUE 2022,LIMTED VALUE 2023,LPV VARIANCE 2223,TOTAL FCV 2021,TOTAL FCV 2022,FCV VARIANCE 2122,TOTAL FCV 2020,TOTAL FCV 2O21,FCV VARIANCE 2021,TOTAL FCV 2019,TOTAL FCV 2020,FCV VARIANCE 1920,TOTAL FCV 2018,TOTAL FCV 2019,FCV VARIANCE 1819,LIMITED VALUE 2017,LIMITED VALUE 2018,TOTAL FCV 2019,LPV VARIANCE 1718,County
10127023,K RANCH-PATAGONIA HWY,24000,24000,0,24000,24000,0,24000,24000,0,24000,24000,0,24000,24000,0,24000,24000,0,24000,24000,0,24000,24000,0,24000,24000,0,24000,24000,0,24000,24000,24000,0,NPM #1 SANTA CRUZ
10127024,K RANCH-PATAGONIA HWY,132285,134585,2300,118952,124900,5948,125832,132285,6453,113288,118952,5664,107893,125832,17939,107893,113288,5395,106350,107893,1543,106254,106350,96,103294,106254,2960,100792,103294,2502,96351,100792,103294,2502,NPM #1 SANTA CRUZ
10130009,K RANCH-N PERKINS AVE SUB BARRY LOT 5,11700,11700,0,11700,11700,0,11700,11700,0,11700,11700,0,11700,11700,0,11700,11700,0,11700,11700,0,11700,11700,0,11700,11700,0,11700,11700,0,11700,11700,11700,0,NPM #1 SANTA CRUZ
10143108A 7,WS APTS - 180 N WEST ST,142754,141607,-1147,95316,100082,4766,140031,142754,2723,90777,95316,4539,107499,140031,32532,86455,90778,4323,82338,107499,25161,82551,82338,-213,79323,82551,3228,78830,79323,493,76123,78830,79323,493,NPM #1 SANTA CRUZ
10145078,CRAWFORT LOTS,5650,5650,0,5650,5650,0,,,0,,,0,5650,5650,0,5650,5650,0,5650,5650,0,5650,5650,0,5650,5650,0,5650,5650,0,5650,5650,5650,0,NPM #1 SANTA CRUZ
10146055,CHURCH - 39 N SONOITA AVE,87450,87450,0,87450,87450,0,87450,87450,0,87450,87450,0,87450,87450,0,87450,87450,0,87450,87450,0,87450,87450,0,87450,87450,0,87450,87450,0,87450,87450,87450,0,NPM #1 SANTA CRUZ
10149022,MORLEY CROSS RD- 338 N MORLEY AVE,359017,364482,5465,303950,319148,15198,293869,359017,65148,289476,303950,14474,275692,293869,18177,275692,289477,13785,269496,275692,6196,262364,269496,7132,252909,262364,9455,247815,252909,5094,224332,235549,247326,11777,NPM #1 SANTA CRUZ
10213006E,BV APTS (SOUTH OF),42960,42960,0,42960,42960,0,42960,42960,0,42960,42960,0,42960,42960,0,42960,42960,0,42960,42960,0,42960,42960,0,42960,42960,0,42960,42960,0,42960,42960,42960,0,NPM #1 SANTA CRUZ
10522008D,BATTING CAGES/MH NORTHCROSS -Added 1.30.19,166833,166833,0,166833,166833,0,166833,166833,0,166833,166833,0,166833,166833,0,166833,166833,0,193093,197467,4374,191122,193093,1971,760,760,0,760,760,0,760,760,760,0,NPM #1 SANTA CRUZ
10522013,DRIVE INN ANNIE'S - 3255 N GRAND AVE,39204,39204,0,30340,31857,1517,39204,39204,0,28895,30340,1445,39204,39204,0,27519,28895,1376,39204,39204,0,39204,39204,0,39204,39204,0,39204,39204,0,21562,22640,23772,1132,NPM #1 SANTA CRUZ
10522027,MH-(OFFICES) - 3131 N GRAND AVE,355106,313371,-41735,319932,313371,-6561,309825,352525,42700,304697,319932,15235,290188,309825,19637,290188,304697,14509,288724,290188,1464,284647,288724,4077,268101,284647,16546,271029,268101,-2928,231341,242908,255053,12145,NPM #1 SANTA CRUZ
10201005 7,BIRD HILL M.H.P/AUG '04 - 2133 N GRAND AE,313190,321019,7829,293026,307677,14651,279072,313190,34118,279072,293026,13954,274540,279072,4532,274540,279072,4532,272146,274540,2394,268091,272146,4055,263550,268091,4541,260420,263550,3130,243246,255408,263550,8142,NPM #1 SANTA CRUZ
10201005A,BIRD HILL M.H.P. 33 ACRES - 2085 N GRAND AVE,77367,75850,-1517,65310,68576,3266,66306,77367,11061,62200,65310,3110,59238,66306,7068,59238,62200,2962,57599,59238,1639,58162,57599,-563,55350,58162,2812,53577,55350,1773,50888,53432,55350,1918,NPM #1 SANTA CRUZ
10201012A 6,VETERANS/SEPT'04 - 570 W MARIPOSA RD,1989047,1734079,-254968,1304767,1370005,65238,1282593,1989047,706454,1242635,1304767,62132,1282815,1282815,0,1282815,1282815,0,1405092,1412938,7846,1121547,1152181,30634,1095029,1121547,26518,1108846,1095029,-13817,1012977,1063626,1095029,31403,NPM #1 SANTA CRUZ
10201034B,SANCHEZ 156 W MARIPOSA RD,541336,545645,4309,418615,439546,20931,411501,541336,129835,398681,524286,125605,411501,411501,0,395485,398681,3196,462366,470821,8455,454780,462366,7586,442535,454780,12245,435250,442535,7285,405603,425883,442535,16652,NPM #1 SANTA CRUZ
10201036A 6,"PRESTON M.H.P./APR.'04 * -          $1,317,578",1401874,1414775,12901,1299174,1364134,64960,1237309,1401874,164565,1237309,1299174,61865,1237309,1237309,0,1237309,1237309,0,1312713,1317578,4865,1304246,1312713,8467,1294848,1304246,9398,1288607,1294848,6241,1261518,1288607,1294848,6241,NPM #1 SANTA CRUZ
10201036B,2085 N GRAND/MINI STORAGE,1532820,1398661,-134159,1265483,1328757,63274,1277668,1532820,255152,1205223,1265483,60260,1147831,1277668,129837,1147831,1205223,57392,1147831,1147831,0,1212625,1247987,35362,1180926,1212625,31699,1170246,1180926,10680,1086811,1141152,1180926,39774,NPM #1 SANTA CRUZ
10201038,LAS PALMAS - 2050 N. SMOOKEY LN,4734371,4517953,-216418,796717,836553,39836,3753035,4734371,981336,758778,796717,37939,3463141,3753035,289894,722646,758778,36132,3437243,3463141,25898,3298144,3437243,139099,3186382,3298144,111762,3168171,3186382,18211,566213,594524,624249,29725,NPM #1 SANTA CRUZ
10201083 3,MASTICK WAY - 81 W. MARIPOSA WAY,223463,223463,0,223463,223463,0,223463,223463,0,223463,223463,0,223463,223463,0,223463,223463,0,223463,223463,0,223463,223463,0,223463,223463,0,223463,223463,0,223463,223463,223463,0,NPM #1 SANTA CRUZ
10201088,RRR LOT B - OCEAN GARDEN DR,44649,44649,0,44649,44649,0,44649,44649,0,44649,44649,0,44649,44649,0,44649,44649,0,44649,44649,0,44649,44649,0,44649,44649,0,44649,44649,0,44649,44649,44649,0,NPM #1 SANTA CRUZ
10201089,RRR LOT C - 2047 OCEAN GARDEN DR (DESERT SKY),434094,388551,-45543,355831,373623,17792,348104,434094,85990,338887,355831,16944,322749,348104,25355,322749,338886,16137,319559,322749,3190,307585,319559,11974,304311,307585,3274,306061,304311,-1750,278203,292113,304311,12198,NPM #1 SANTA CRUZ
10201098D 3,CRISPY FOODS -VETERANS/570 W MARIPOSA RD/CW,997455,893804,-103651,877958,893804,15846,850091,997455,147364,836150,877958,41808,796333,850091,53758,796333,836150,39817,774684,796333,21649,762815,774684,11869,742752,762815,20063,748769,742752,-6017,671465,705038,740290,35252,NPM #1 SANTA CRUZ
10202009 2,KORY WHSE - 2347 N GRAND AVE,257528,239786,-17742,238359,239786,1427,227009,257528,30519,227009,238359,11350,217932,227009,9077,217932,227009,9077,216881,217932,1051,212702,216881,4179,210477,212702,2225,212141,210477,-1664,202416,212141,210477,-1664,NPM #1 SANTA CRUZ
10203008G,SAN FELIPE LOTS - MARIPOSA RANCH RD,71000,65000,-6000,11025,11576,551,55000,71000,16000,10500,11025,525,10000,55000,45000,10000,10500,500,10000,10000,0,10000,10000,0,10000,10000,0,10000,10000,0,10000,10000,10000,0,NPM #1 SANTA CRUZ
10203008H,SAN FELIPE LOTS - MARIPOSA RANCH RD,71000,65000,-6000,551,579,28,55000,71000,16000,525,551,26,500,55000,54500,500,525,25,500,500,0,500,500,0,500,500,0,500,500,0,500,500,500,0,NPM #1 SANTA CRUZ
10203018A,SAN FELIPE LOTS,52194,52194,0,52194,52194,0,52194,52194,0,52194,52194,0,52194,52194,0,52194,52194,0,52194,52194,0,52194,52194,0,52194,52194,0,52194,52194,0,52194,52194,52194,0,NPM #1 SANTA CRUZ
10203021B,SAN FELIPE LOTS - MARIPOSA RANCH RD,55242,55242,0,55242,55242,0,55242,55242,0,55242,55242,0,55242,55242,0,55242,55242,0,55242,55242,0,55242,55242,0,55242,55242,0,55242,55242,0,55242,55242,55242,0,NPM #1 SANTA CRUZ
10203022,SAN FELIPE LOTS,30051,30051,0,30051,30051,0,30051,30051,0,30051,30051,0,30051,30051,0,30051,30051,0,30051,30051,0,30051,30051,0,30051,30051,0,30051,30051,0,30051,30051,30051,0,NPM #1 SANTA CRUZ
10203048,MOLERA PARCEL,28026,28026,0,28026,28026,0,28026,28026,0,28026,28026,0,28026,28026,0,28026,28026,0,28026,28026,0,28026,28026,0,28026,28026,0,28026,28026,0,,28026,28026,0,NPM #1 SANTA CRUZ
10204002A,ESCALADA 205 ACRES - W CIMARRON,4101,3691,-410,4101,3691,-410,4101,4101,0,4101,4101,0,4101,4101,0,4101,4101,0,4101,4101,0,4101,4101,0,4101,4101,0,4101,4101,0,,4101,4101,0,NPM #1 SANTA CRUZ
10204010E 5,MARIPOSA  INDUSTRIAL PARK I,167837,167837,0,167837,167837,0,167837,167837,0,167837,167837,0,176550,176550,0,176550,176550,0,176550,176550,0,176550,176550,0,176550,176550,0,176550,176550,0,176550,176550,176550,0,NPM #1 SANTA CRUZ
10204019A 6,M I P    II - 1150 N IND PK DR,314142,263265,-50877,273117,263265,-9852,267535,314142,46607,260112,273118,13006,247726,267535,19809,247726,260112,12386,243763,247726,3963,238167,243763,5596,238531,238167,-364,240123,238531,-1592,225291,236556,238531,1975,NPM #1 SANTA CRUZ
10204019B 5,M I P    II - 1144 W. IND. PARK DR,647342,568964,-78378,560058,568964,8906,541736,647342,105606,533388,560057,26669,507989,541736,33747,507989,533388,25399,507989,507989,0,499710,515209,15499,488716,499710,10994,496193,488716,-7477,478073,496193,488716,-7477,NPM #1 SANTA CRUZ
10204024A 0,M I P    II - 1200 W IND PARK STE C (ACESSUM),1928004,1711497,-216507,1584483,1663707,79224,1570706,1928004,357298,1509031,1584483,75452,1437173,1570706,133533,1437173,1509032,71859,1437173,1437173,0,1427987,1477513,49526,1349038,1427987,78949,1409094,1349038,-60056,1349038,1409094,1349038,-60056,NPM #1 SANTA CRUZ
10204043A 5,M I P    I - 1481 N IND PARK DR 3 (R.L.R.),898253,761951,-136302,740249,761951,21702,727668,898253,170585,704998,869961,164963,670099,727668,57569,670099,703604,33505,670099,670099,0,665962,690322,24360,612962,665962,53000,670575,612962,-57613,612962,643610,110333,-533277,NPM #1 SANTA CRUZ
10204044C 6,M I P    III - 1481 N. IND. PARK DR,600828,535519,-65309,510300,535519,25219,497621,600828,103207,486000,510300,24300,462857,497621,34764,462857,486000,23143,462857,462857,0,455833,470180,14347,456899,455833,-1066,457866,456899,-967,455879,457866,456899,-967,NPM #1 SANTA CRUZ
10204048A,"MIP II - 1140 W MARIPOSA IND PARK (ARIVEL, TWIN PLANT)",767724,645879,-121845,616451,645879,29428,606075,767724,161649,587096,616451,29355,559139,606075,46936,559139,587096,27957,554408,559139,4731,565084,554408,-10676,565084,565084,0,565084,565084,0,482722,506858,532201,25343,NPM #1 SANTA CRUZ
10204051,MARIPOSA IND. PARK LOT 12 - 1270 N INDUSTRIAL PARK AVE,2169185,1932702,-236483,1785493,1874768,89275,1775944,2169182,393238,1700469,1785492,85023,1619495,1775944,156449,1619495,1700470,80975,1619495,1619495,0,1617181,1668712,51531,1585867,1617181,31314,1578187,1585867,7680,1452272,1524886,1585867,60981,NPM #1 SANTA CRUZ
10204052,MARIPOSA IND. PARK LOT 13 - 1171 N INDUSTRIAL PARK DR,803735,728142,-75593,660041,693043,33002,650017,803735,153718,628610,660041,31431,598677,650017,51340,598677,628611,29934,598677,598677,0,597084,619142,22058,537839,597084,59245,537839,537839,0,537839,537839,537839,0,NPM #1 SANTA CRUZ
10206017 7,130 W. WHITE RD./SONIC P 5/14/09,380351,378852,-1499,341137,358194,17057,331264,380351,49087,324893,341138,16245,311656,331264,19608,309421,324892,15471,302700,311656,8956,292726,296926,4200,286799,292726,5927,268837,286799,17962,293590,248146,274492,26346,NPM #1 SANTA CRUZ
10206018 0,120 W. WHITE RD./CRISPY F. P.2/17/09,468668,386062,-82606,399486,386062,-13424,383211,468668,85457,380463,399486,19023,362346,383211,20865,362346,380463,18117,354426,362346,7920,347059,354426,7367,334691,347059,12368,347812,334691,-13121,328243,344655,334691,-9964,NPM #1 SANTA CRUZ
10207043A,861 W CIARDULLI PL,,,0,,,0,,,0,,,0,,,0,,,0,,,0,SOLD,,#VALUE!,,SOLD,,375671,382453,6782,239980,354609,372339,17730,NPM #1 SANTA CRUZ
10206034,OASIS TOWNE CENTRE BLOCK 7 - 10.55 ACRES,211,190,-21,211,190,-21,211,211,0,211,211,0,211,211,0,211,211,0,211,211,0,,,,,,,,,,,,,,NPM #1 SANTA CRUZ
10206035,OASIS TOWNE CENTRE BLOCK 8-A - 8.16 ACRES,163,147,-16,163,147,-16,163,163,0,163,163,0,163,163,0,163,163,0,163,163,0,,,,,,,,,,,,,,NPM #1 SANTA CRUZ
10213017,HOLLER - 1041 W TARGET RANGE RD,46022,46022,0,46022,46022,0,46022,46022,0,46022,46022,0,46022,46022,0,46022,46022,0,46022,46022,0,46022,46022,0,46022,46022,0,46022,46022,0,46022,46022,46022,0,NPM #1 SANTA CRUZ
10213020,BUENA VISTA APTS.- 311 N. MCNAB DR,915000,915000,0,915000,915000,0,915000,915000,0,915000,915000,0,915000,915000,0,915000,915000,0,915000,915000,0,915000,915000,0,915000,915000,0,925778,941125,15347,898112,925778,941125,15347,NPM #1 SANTA CRUZ
10306007,NOGALES DEVELOPMENT - (GRAZING) -ESCALADA OASIS,4379,3941,-438,4379,3941,-438,4379,4379,0,4379,4379,0,4379,4379,0,4379,4379,0,4379,4379,0,4379,4379,0,4379,4379,0,4379,4379,0,4379,4169,4377,208,NPM #1 SANTA CRUZ
10309014,K-RANCH,30432,30432,0,30432,30432,0,30432,30432,0,30432,30432,0,30432,30432,0,30432,30432,0,30432,30432,0,30432,30432,0,30432,30432,0,30432,30432,0,30432,30432,30432,0,NPM #1 SANTA CRUZ
10310017D,ROYAL RD RANCH,4605,4144,-461,4605,4144,-461,4605,4605,0,4605,4605,0,4605,4605,0,4605,4605,0,4605,4605,0,4605,4605,0,4605,4605,0,4605,4605,0,4605,4605,4605,0,NPM #1 SANTA CRUZ
10310024A,K-RANCH - 870 N PERKINS AVE (SUNSHINE PRESCHOOL),356974,344304,-12670,255522,268297,12775,300043,356974,56931,243355,255522,12167,231766,300043,68277,231766,243354,11588,243033,231766,-11267,259170,243033,-16137,291389,259170,-32219,291389,291389,0,277513,291389,291389,0,NPM #1 SANTA CRUZ
10310026 1,K-RANCH,758,683,-75,758,683,-75,758,758,0,758,758,0,758,758,0,758,758,0,758,758,0,758,758,0,758,758,0,758,758,0,758,758,758,0,NPM #1 SANTA CRUZ
10508004,NORAH'S RANCH SE,4091,4091,0,4091,4091,0,4091,4091,0,4091,4091,0,4091,4091,0,4091,4091,0,4091,4091,0,4091,4091,0,4091,4091,0,4091,4091,0,4091,4091,4091,0,NPM #1 SANTA CRUZ
10520003,CANYON  APTS - 10 N NIKOS WAY,587615,568998,-18617,492785,517424,24639,491920,587615,95695,469319,492785,23466,446970,491920,44950,446970,469319,22349,438053,446970,8917,426406,438053,11647,392702,426406,33704,392766,392702,-64,359414,377385,392702,15317,NPM #1 SANTA CRUZ
10520004A 9,MORGAN                 FLOOD PLANE      30 OLD TUCSON RD,3357731,2803748,-553983,2533678,2660362,126684,2413027,3357731,944704,2413027,2533678,120651,2413027,2413027,0,2413027,2413027,0,2457654,2593973,136319,2457654,2457654,0,2542340,3541823,999483,2542340,2542340,0,2542340,2542340,2542340,0,NPM #1 SANTA CRUZ
10520008 2,CANYON HOUSE/RANCH HOUSE - 16 NIKOS WAY,1074874,1149407,74533,492266,516879,24613,829893,1074874,244981,468824,492265,23441,682423,829893,147470,446499,468824,22325,579040,682423,103383,579487,579040,-447,469031,579487,110456,455296,469031,13735,349843,367335,385702,18367,NPM #1 SANTA CRUZ
10520009B,CASA MOLINA RESTAURANT / 555 E FRONTAGE RD,41404,41404,0,41404,41404,0,41404,41404,0,41404,41404,0,41404,41404,0,41404,41404,0,41404,41404,0,41404,41404,0,41404,41404,0,41404,41404,0,,41404,41404,0,NPM #1 SANTA CRUZ
10520009C 2,PK OLD HSE *- CHINETO- 50 NIKOS WAY,606707,579427,-27280,486770,511107,24337,496345,606707,110362,463591,486770,23179,463790,496345,32555,441515,463591,22076,443978,463790,19812,443978,443978,0,421134,443978,22844,121451,421134,299683,118064,121451,376076,254625,NPM #1 SANTA CRUZ
10520009G ,PK RANCH,1000,1000,0,1000,1000,0,1000,1000,0,1000,1000,0,1000,1000,0,1000,1000,0,1000,1000,0,1000,1000,0,1000,1000,0,1000,1000,0,1000,1000,1000,0,NPM #1 SANTA CRUZ
10520009K 1,CASITA PROKTER,113222,110030,-3192,103303,108468,5165,98384,113222,14838,98384,103303,4919,94156,98384,4228,94156,98384,4228,89867,94156,4289,89867,89867,0,89867,100599,10732,85277,89867,4590,85277,85277,89541,4264,NPM #1 SANTA CRUZ
10521001,PK McCOY - 3751 E FRONTAGE RD,215865,228525,12660,148083,155487,7404,169609,215865,46256,141031,148083,7052,141163,169609,28446,99243,104204,4961,121010,141163,20153,121177,121010,-167,100422,121177,20755,98149,100422,2273,77759,81646,85728,4082,NPM #1 SANTA CRUZ
10520010,PK FIELDS - OLD TUCSON HWY,1448462,1534071,85609,759955,797953,37998,1137966,1448462,310496,723767,759955,36188,942687,1137966,195279,689302,723767,34465,807618,942687,135069,808702,807618,-1084,670872,808702,137830,650860,670872,20012,422347,567090,595445,28355,NPM #1 SANTA CRUZ
10522023 1,DRIVE INN - 3269 N GRAND AVE,3132185,2695543,-436642,2540371,2667391,127020,2501788,3132185,630397,2419400,2540371,120971,2304191,2501788,197597,2304191,2419401,115210,2202386,2304191,101805,2202386,2202386,0,2853153,2929400,76247,2871772,2853153,-18619,2084760,2188998,2298448,109450,NPM #1 SANTA CRUZ
10522134B,VILLA HERMOSA APTS.,89558,85367,-4191,68704,72139,3435,73010,89558,16548,65432,68704,3272,62316,73010,10694,62316,65432,3116,62040,62316,276,62290,62040,-250,60676,62290,1614,59735,60676,941,58415,59735,60676,941,NPM #1 SANTA CRUZ
10524002 6,FLAGSTONE APTS/OFFICES 2841 N GRAND AVE,682104,724238,42134,508427,533848,25421,571060,682104,111044,484217,508427,24210,517659,571060,53401,461159,484217,23058,516069,517659,1590,495956,516069,20113,429022,495956,66934,428922,429022,100,361329,379396,398366,18970,NPM #1 SANTA CRUZ
10524024,VALLE VERDE APTS,612991,591074,-21917,467087,490441,23354,496322,612991,116669,444845,467087,22242,423662,496322,72660,423662,444845,21183,422901,423662,761,425288,422901,-2387,430937,425288,-5649,430937,430937,0,489045,430937,430937,0,NPM #1 SANTA CRUZ
10528016 9,VOHLAND - 274 W PRODUCE R,459266,437941,-21325,368412,386833,18421,370674,459266,88592,350869,368412,17543,334161,370674,36513,334161,350869,16708,334161,334161,0,350497,372536,22039,350497,350497,0,384824,423405,38581,384644,384824,404065,19241,NPM #1 SANTA CRUZ
10528017A1,VEGGIES - 274 W PRODUCE R,323314,330621,7307,273461,287134,13673,274485,323314,48829,260439,273461,13022,248037,274485,26448,248037,260439,12402,248037,248037,0,253651,273806,20155,253651,253651,0,237977,287758,49781,237977,237977,249876,11899,NPM #1 SANTA CRUZ
10528017B,NORTH FOOD BANK,8494,8494,0,8494,8494,0,8494,8494,0,8494,8494,0,8494,8494,0,8494,8494,0,8494,8494,0,8494,8494,0,16988,16988,0,16988,16988,0,16988,16988,16988,0,NPM #1 SANTA CRUZ
10533019A,417 CAMINO VISTA DEL CIELO,113978,113586,-392,113978,113586,-392,110289,113978,3689,110289,113978,3689,109099,110289,1190,109099,110289,1190,108650,109099,449,108650,108650,0,107981,108650,669,107995,107981,-14,106170,107995,107981,-14,NPM #1 SANTA CRUZ
10778094B,WINDEMERE HOTEL- SIERRA VISTA            SOLD 09/09/23,,,0,,,0,,,0,,,0,3000000,3000000,0,3000000,3000000,0,3725000,3725000,0,3725000,3725000,0,,,0,3725000,3725000,0,3725000,3725000,3725000,0,NPM #1 SANTA CRUZ
11212099B 3,TUBAC (EL MERCADO) 2261 E FRONTAGE RD,956811,924282,-32529,619225,650186,30961,840190,956811,116621,589738,619225,29487,805398,840190,34792,561655,589738,28083,788266,805398,17132,780788,788266,7478,758608,780788,22180,764780,758608,-6172,440070,462074,485178,23104,NPM #1 SANTA CRUZ
11244557,TUBAC LOT 157- 1602 GOLDEN GATE WAY-SOLD,,,0,,,0,29925,185097,155172,29925,164162,134237,2500,29925,27425,2500,29925,27425,2500,2500,0,2500,2500,0,16520,16520,0,16520,16520,0,,16520,16520,0,NPM #1 SANTA CRUZ
11244558,TUBAC LOT 158- 1604 GOLDEN GATE WAY - SOLD 11.30.23,224002,219777,-4225,198667,208600,9933,47710,174726,127016,45820,154964,109144,2500,25792,23292,2500,25792,23292,2500,2500,0,2500,2500,0,14238,14238,0,14238,14238,0,,14238,14238,0,NPM #1 SANTA CRUZ
11244559,TUBAC LOT 159- 1606 GOLDEN GATE WAY,221045,217508,-3537,196045,205847,9802,47710,172360,124650,45820,152866,107046,2500,25792,23292,2500,25792,23292,2500,2500,0,2500,2500,0,14238,14238,0,14238,14238,0,,14238,14238,0,NPM #1 SANTA CRUZ
11244560,TUBAC LOT 160- 1608 GOLDEN GATE WAY,207466,203898,-3568,184001,193201,9200,25792,38875,13083,25792,34478,8686,2500,25792,23292,2500,25792,23292,2500,2500,0,2500,2500,0,14238,14238,0,14238,14238,0,,14238,14238,0,NPM #1 SANTA CRUZ
11244561,TUBAC LOT 161- 1610 GOLDEN GATE WAY,209813,206202,-3611,183083,195387,12304,25792,51959,26167,25792,46082,20290,2500,25792,23292,2500,25792,23292,2500,2500,0,2500,2500,0,14238,14238,0,14238,14238,0,,14238,14238,0,NPM #1 SANTA CRUZ
11244562,TUBAC LOT 162- 1612 GOLDEN GATE WAY-SOLD 04.18.24,265753,261122,-4631,235695,247480,11785,29925,81885,51960,29925,72624,42699,2500,29925,27425,2500,29925,27425,2500,2500,0,2500,2500,0,16520,16520,0,16520,16520,0,,16520,16520,0,NPM #1 SANTA CRUZ
11244563,SUB EMBARC. AT BARRIO DE TUBAL LOT 163 1611 GGW,271071,266342,-4729,240412,252433,12021,29925,82502,52577,29925,73171,43246,2500,29925,27425,2500,29925,27425,2500,2500,0,2500,2500,0,16520,16520,0,16520,16520,0,,16520,16520,0,NPM #1 SANTA CRUZ
11244564,TUBAC LOT 164- 1609 GOLDEN GATE WAY,207466,203898,-3568,184001,193201,9200,25792,111217,85425,25792,98638,72846,2500,25792,23292,2500,25792,23292,2500,2500,0,2500,2500,0,14238,14238,0,14238,14238,0,,14238,14238,0,NPM #1 SANTA CRUZ
11244565,TUBAC LOT 165- 1607 GOLDEN GATE WAY,225690,197845,-27845,200164,197845,-2319,25792,25792,0,25792,25792,0,2500,25792,23292,2500,25792,23292,2500,2500,0,2500,2500,0,14238,14238,0,14238,14238,0,,14238,14238,0,NPM #1 SANTA CRUZ
11244566,TUBAC LOT 166- 1605 GOLDEN GATE WAY,217216,213129,-4087,192649,202281,9632,25792,169413,143621,25792,150252,124460,2500,25792,23292,2500,25792,23292,2500,2500,0,2500,2500,0,14238,14238,0,14238,14238,0,,14238,14238,0,NPM #1 SANTA CRUZ
11244567,TUBAC LOT 167- 1603 GOLDEN GATE WAY,218946,214823,-4123,194183,203892,9709,45658,167537,121879,43849,148588,104739,2500,25792,23292,2500,25792,23292,2500,2500,0,2500,2500,0,14238,14238,0,14238,14238,0,,14238,14238,0,NPM #1 SANTA CRUZ
11244568,TUBAC LOT 168- 1601 GOLDEN GATE WAY-SOLD 09.18.23,,,0,,,0,29925,209224,179299,29925,185560,155635,2500,29925,27425,2500,29925,27425,2500,2500,0,2500,2500,0,16520,16520,0,16520,16520,0,,16520,16520,0,NPM #1 SANTA CRUZ
11244569,TUBAC LOT 169,8135,8135,0,8135,8135,0,8135,8135,0,8135,8135,0,2500,29925,27425,2500,29925,27425,SOLD,,,2500,2500,0,16520,16520,0,16520,16520,0,,16520,16520,0,NPM #1 SANTA CRUZ
11244570,TUBAC LOT 170,8135,8135,0,8135,8135,0,8135,8135,0,8135,8135,0,2500,27023,24523,2500,27023,24523,2500,2500,0,2500,2500,0,16520,16520,0,14918,14918,0,,14918,14918,0,NPM #1 SANTA CRUZ
11244571,TUBAC LOT 171,8135,8135,0,8135,8135,0,8135,8135,0,8135,8135,0,2500,25792,23292,2500,25792,23292,SOLD,,,2500,2500,0,14238,14238,0,14238,14238,0,,14238,14238,0,NPM #1 SANTA CRUZ
11244572,TUBAC LOT 172,8135,8135,0,8135,8135,0,8135,8135,0,8135,8135,0,2500,25792,23292,2500,25792,23292,2500,2500,0,2500,2500,0,14238,14238,0,14238,14238,0,,14238,14238,0,NPM #1 SANTA CRUZ
11244573,TUBAC LOT 173,8135,8135,0,8135,8135,0,8135,8135,0,8135,8135,0,2500,25792,23292,2500,25792,23292,2500,2500,0,2500,2500,0,14238,14238,0,14238,14238,0,,14238,14238,0,NPM #1 SANTA CRUZ
11244574,TUBAC LOT 174,8135,8135,0,8135,8135,0,8135,8135,0,8135,8135,0,2500,29925,27425,2500,29925,27425,2500,2500,0,2500,2500,0,16520,16520,0,16520,16520,0,,16520,16520,0,NPM #1 SANTA CRUZ
11244575,TUBAC LOT 175,8135,8135,0,8135,8135,0,8135,8135,0,8135,8135,0,2500,29925,27425,2500,29925,27425,SOLD,,,2500,2500,0,16520,16520,0,16520,16520,0,,16520,16520,0,NPM #1 SANTA CRUZ
11244576,TUBAC LOT 176,8135,8135,0,8135,8135,0,8135,8135,0,8135,8135,0,2500,25792,23292,2500,25792,23292,2500,2500,0,2500,2500,0,14238,14238,0,14238,14238,0,,14238,14238,0,NPM #1 SANTA CRUZ
11244577,TUBAC LOT 177,8135,8135,0,8135,8135,0,8135,8135,0,8135,8135,0,2500,25792,23292,2500,25792,23292,2500,2500,0,2500,2500,0,14238,14238,0,14238,14238,0,,14238,14238,0,NPM #1 SANTA CRUZ
11244578,TUBAC LOT 178,8135,8135,0,8135,8135,0,8135,8135,0,8135,8135,0,2500,25792,23292,2500,25792,23292,2500,2500,0,2500,2500,0,14238,14238,0,14238,14238,0,,14238,14238,0,NPM #1 SANTA CRUZ
11244579,TUBAC LOT 179,8135,8135,0,8135,8135,0,8135,8135,0,8135,8135,0,2500,25792,23292,2500,25792,23292,2500,2500,0,2500,2500,0,14238,14238,0,14238,14238,0,,14238,14238,0,NPM #1 SANTA CRUZ
11244580,TUBAC LOT 180,8135,8135,0,8135,8135,0,8135,8135,0,8135,8135,0,2500,29925,27425,2500,29925,27425,SOLD,,,2500,2500,0,16520,16520,0,16520,16520,0,,16520,16520,0,NPM #1 SANTA CRUZ
11246011 8,PALO PARADO,31382,33260,1878,26148,27455,1307,27906,31382,3476,24902,26147,1245,26303,27906,1603,23717,24902,1185,24977,26303,1326,56782,57093,311,54317,56782,2465,53174,54317,1143,53195,53174,54317,1143,NPM #1 SANTA CRUZ
11338002A,RUBY SOUTHWEST - TRAILER -GRAZING,551,496,-55,551,496,-55,551,551,0,551,551,0,551,551,0,551,551,0,551,551,0,551,551,0,551,551,0,551,551,0,551,551,551,0,NPM #1 SANTA CRUZ
11338003A,NORAHS RANCH N1/2,683,683,0,683,683,0,683,683,0,683,683,0,683,683,0,683,683,0,683,683,0,683,683,0,683,683,0,75377,,,3063250,66745,,,NPM #1 SANTA CRUZ
11338007A,NORA NORTH 3- 293 OLD TUCSON RD,6201966,14683174,8481208,4938788,10156486,5217698,658,658,0,658,658,0,658,658,0,658,658,0,658,658,0,65760,65760,0,65760,65760,0,65760,65760,0,,63581,65760,2179,NPM #1 SANTA CRUZ
11338008,NORAH'S RANCH FRONT PT-296 OLD TUCSON RD,500,500,0,500,500,0,500,500,0,500,500,0,500,500,0,500,500,0,500,500,0,500,500,0,500,500,0,500,500,0,500,500,500,0,NPM #1 SANTA CRUZ
11338014,NORAH'S RANCH NORTH SIDE/298 OLD TUCSON RD,500,500,0,500,500,0,500,500,0,500,500,0,500,500,0,500,500,0,500,500,0,500,500,0,500,500,0,500,500,0,500,500,500,0,NPM #1 SANTA CRUZ
11338016,NORAH'S RANCH/707 E FRONTAGE RD-NORAS-DELTA,4151325,3946528,-204797,2304264,2419477,115213,3247800,4151325,903525,2194537,2304264,109727,3004798,3247800,243002,2090036,2194538,104502,2978995,3004798,25803,2837802,2978995,141193,1928158,2837802,909644,1928158,347069,-1581089,0,1719478,1805452,85974,NPM #1 SANTA CRUZ
11338017,NORAH'S RANCH/707 E FRONTAGE RD-NORAS1-DELTA,7865877,7465168,-400709,4799943,5039940,239997,6148112,7865877,1717765,4571374,4799943,228569,5686622,6148112,461490,4353690,4571375,217685,5637098,5686622,49524,5368754,5637098,268344,3760881,5368754,1607873,3760881,3760881,0,0,3760881,3760881,0,NPM #1 SANTA CRUZ
11338018,NORAH'S - KALIROY/DELTA,3472476,3559175,86699,1600377,1680396,80019,3127159,3472476,345317,1524168,1600376,76208,2910255,3127159,216904,1451589,1524168,72579,2141640,2141640,0,1316634,2141640,825006,1316634,1316634,0,1691784,2082946,391162,0,1508686,1584120,75434,NPM #1 SANTA CRUZ
11343003B,PK WEST- GRAZING 2023,218,196,-22,218,218,0,218,218,0,217,218,1,27250,27250,0,27250,27250,0,27250,27250,0,27250,27250,0,27250,27250,0,27250,27250,0,27200,27250,27250,0,NPM #1 SANTA CRUZ
11345165A 5,FAIRWAY- 3975 FAIRWAY -  PROTECH/OCT'04,869966,869966,0,869966,869966,0,869966,869966,0,869966,869966,0,869966,869966,0,869966,869966,0,869966,869966,0,869966,869966,0,813246,869966,56720,813246,813246,0,813246,813246,813246,0,NPM #1 SANTA CRUZ
11345169,SANCHEZ HSE - 1488 POTRERO,,,0,,,0,,,0,,,0,,,0,,,0,,,0,,,,SOLD,,,172000,172000,0,172648,172000,172000,0,NPM #1 SANTA CRUZ
11345367,MEADOW HILLS - 1310 FAIRWAY,921233,916714,-4519,734851,771594,36743,699858,921233,221375,699858,734851,34993,699858,699858,0,699858,699858,0,880657,922249,41592,880657,880657,0,1214916,1269646,54730,1218170,1214916,-3254,1088366,1142784,1199923,57139,NPM #1 SANTA CRUZ
11346037A 0,MARIPOSA RANCH LOTG - 1590 W CALLE PLATA,1099478,1099478,0,1099478,1099478,0,1099478,1099478,0,1099478,1099478,0,1099478,1099478,0,1099478,1099478,0,1099478,1099478,0,1084381,1121345,36964,1077769,1084381,6612,1077769,1077769,0,1072583,1077769,1077769,0,NPM #1 SANTA CRUZ
11346038C 1,MARIPOSA RANCH LOTK - 1420 N MARIOSA RANCH RD,448500,377239,-71261,378222,377239,-983,366856,448500,81644,360211,378222,18011,343059,366856,23797,343059,360212,17153,340494,343059,2565,329071,340494,11423,320300,329071,8771,322983,320300,-2683,300409,315429,320300,4871,NPM #1 SANTA CRUZ
11346051 1,LA QUINTA II LOT 1 - FLO0D PLANE    ,2624633,2624633,0,2624633,2624633,0,2624633,2624633,0,2624633,2624633,0,2624633,2624633,0,2624633,2624633,0,2624633,2624633,0,2624633,2624633,0,2623722,3027579,403857,2623722,2623722,0,2623722,2623722,2623722,0,NPM #1 SANTA CRUZ
11349013A 9,MARIPOSA III,,,0,,,0,,,0,,,0,,,0,,,0,,,0,,,,,,0,,,0,,,,0,NPM #1 SANTA CRUZ
11349013B 8,11 ACRES MARIPOSA II  /  480 N MARIPOSA RD,8875120,8623813,-251307,6113091,6418746,305655,6052026,8875120,2823094,5821991,8595580,2773589,5544753,6052026,507273,5544753,5821991,277238,5544753,5544753,0,5522479,5736152,213673,5243490,5522479,278989,5724842,5837707,112865,4102286,5284230,5548440,264210,NPM #1 SANTA CRUZ
11349019B 6,N I P - 225 N FREEPORT DR (DAVIDS),1112347,979081,-133266,957605,979081,21476,930748,1112347,181599,912005,957605,45600,868576,930748,62172,868576,912005,43429,868576,868576,0,867960,892194,24234,822185,867960,45775,822185,822185,0,822186,822185,822185,0,NPM #1 SANTA CRUZ
11349019E 3,N I P - 92 N FREEPORT DR (EMPTY LOT),1283749,1150377,-133372,1165436,1150377,-15059,1125967,1283749,157782,1109939,1165436,55497,1057085,1125967,68882,1057085,1109939,52854,1057085,1057085,0,1054372,1076036,21664,1059453,1054372,-5081,1072844,1059453,-13391,1007979,1058379,1059453,1074,NPM #1 SANTA CRUZ
11349019G,NIP - 150 N FREEPORT (CORP ADUANA RIBACOESQU),435495,402780,-32715,380142,399149,19007,371948,435495,63547,362040,380142,18102,344800,371948,27148,344800,362040,17240,340279,344800,4521,332814,340279,7465,329636,332814,3178,329636,329636,0,329801,329636,329636,0,NPM #1 SANTA CRUZ
11349019H 0,N I P - 165 N. FREEPORT DR,258355,230411,-27944,223427,230411,6984,219167,258355,39188,212787,223426,10639,202655,219167,16512,202655,212788,10133,199580,202655,3075,194810,199580,4770,195772,194810,-962,201412,195772,-5640,189347,198814,195772,-3042,NPM #1 SANTA CRUZ
11349024A 1,N I P - 180 N FREEPORT DR (MARINOS WHSE),538088,481721,-56367,438437,460359,21922,428513,538088,109575,417559,438437,20878,397675,428513,30838,397675,417559,19884,394182,397675,3493,378657,394182,15525,370542,378657,8115,370671,370542,-129,342738,359875,370542,10667,NPM #1 SANTA CRUZ
11349024B 0,N I P - 149 N FREEPORT DR (PALLETUSMEX),7832075,7528821,-303254,3369536,3538046,168510,6140208,7832075,1691867,3209081,3369535,160454,5630016,6140208,510192,3056267,3209080,152813,5575546,5630016,54470,5345366,5575546,230180,5113508,5345366,231858,5087517,5139195,51678,2394664,2514398,2640118,125720,NPM #1 SANTA CRUZ
11349026B,BARRON NIP 100 ACRES- 71 N. FREEPORT DR,4644033,4655474,11441,3765867,3954159,188292,3701396,4644033,942637,3586539,3765867,179328,3415752,3701396,285644,3415752,3586540,170788,3379764,3415752,35988,3382923,3379764,-3159,16805,3382923,3366118,16808,16805,-3,16733,16808,16805,-3,NPM #1 SANTA CRUZ
11349030,BARRON NIP 30.04 ACRES - W MARIPOSA RD,601,541,-60,601,541,-60,601,601,0,601,601,0,601,601,0,601,601,0,601,601,0,601,601,0,601,601,0,601,601,0,601,601,601,0,NPM #1 SANTA CRUZ
12130019B,COMMUNICATION TOWER (THEO) -CANCELADO 2015 102-13019B 2018 -102-13019C Y D,,,0,,,0,,,0,,,0,,,0,,,0,,,0,,,,,,0,,,0,,,,0,NPM #1 SANTA CRUZ
12401057 8,1249 CALLE PICO GORDO,209031,205868,-3163,150009,157509,7500,198773,209031,10258,142865,150008,7143,139543,198773,59230,136062,142865,6803,139543,139543,0,123412,158006,34594,118206,123412,5206,115772,118206,2434,115772,115772,118206,2434,NPM #1 SANTA CRUZ
12401062 2,410 VIA CALANDRIA,194593,195418,825,142934,150081,7147,185355,194593,9238,136124,142933,6809,131540,185355,53815,129645,136127,6482,131540,131540,0,117592,150592,33000,113963,117592,3629,110576,113963,3387,110576,110576,113963,3387,NPM #1 SANTA CRUZ
12401064,412 VIA CALANDRIA,189025,192525,3500,189025,192525,3500,184825,189025,4200,184825,189025,4200,184825,184825,0,184825,184825,0,184825,184825,0,184825,184825,0,184825,184825,0,184825,184825,0,145538,152815,160456,7641,NPM #1 SANTA CRUZ
12401072,1209 CAMINO GILBERTO,203229,200025,-3204,150090,157595,7505,109456,203229,93773,71771,150089,78318,93759,109456,15697,68353,71771,3418,77720,93759,16039,61998,77720,15722,61182,61998,816,60384,61182,798,58399,60384,61182,798,NPM #1 SANTA CRUZ
12402102 8,419 CAMINO DEL PATIO,209330,205230,-4100,151081,158635,7554,200157,209330,9173,143887,151081,7194,141066,200157,59091,137036,143888,6852,141066,141066,0,124296,159227,34931,120409,124296,3887,116559,120409,3850,116559,116559,120409,3850,NPM #1 SANTA CRUZ
12403025C,SUB RIO RICO VILLAS UNOT NO 13-1480 W FRONTAGE RD-GRG,129247,124284,-4963,67647,71029,3382,112226,129247,17021,64426,67647,3221,61358,112226,50868,61358,64426,3068,,,,,,,,,,,,,,,,,NPM #1 SANTA CRUZ
12403034,462 AVE PAPALOTE,444047,427764,-16283,229950,241448,11498,342879,444047,101168,219000,229950,10950,235917,342879,106962,208571,219000,10429,235917,235917,0,189180,241342,52162,185272,189180,3908,181470,185272,3802,171538,180115,185272,5157,NPM #1 SANTA CRUZ
14001005 5,COMBATE (K&F) - 9 OJO CT ( FLOOD PLANE),935814,800835,-134979,430803,452343,21540,410289,935814,525525,410289,430803,20514,392594,410289,17695,392594,410289,17695,383855,392594,8739,383855,383855,0,488994,549040,60046,488994,488994,0,454737,477474,488994,11520,NPM #1 SANTA CRUZ
10533070,THANASIS HOUSE - 3204 N CANYON VIEW DR,1280545,1199127,-81418,779355,818323,38968,1077134,1280545,203411,742243,779355,37112,706898,1077134,370236,706898,742243,35345,688927,706898,17971,689892,688927,-965,663415,689892,26477,,,,,,,,NPM #1 SANTA CRUZ
11450012A,RR PLAZA/1060 YAVAPAI DR/CRISPY FOODS,1869180,1923501,54321,1561918,1640014,78096,1548019,1869180,321161,1487541,1561918,74377,2271185,2242910,-28275,2166669,2155284,-11385,1632713,1681387,48674,1499514,1555757,56243,1439543,1499514,59971,,,,,,,,NPM #1 SANTA CRUZ
11450012B,"CRISPY FOODS, LLC - CAR WASH  RIO RICO",782839,778702,-4137,704648,739880,35232,698378,782839,84461,671094,704649,33555,,,,,,,,,,,,,,,,,,,,,,,NPM #1 SANTA CRUZ
11450015A,RR PLAZA-BACK LOT W FRONTAGE RD,54850,54850,0,54850,54850,0,54850,54850,0,54850,54850,0,54850,54850,0,54850,54850,0,548750,54850,-493900,54850,54850,0,54850,54850,0,,,,,,,,NPM #1 SANTA CRUZ
10213019C,BUENA VISTA ANTHENA,5192,5192,0,5192,5192,0,5192,5192,0,5192,5192,0,5192,5192,0,5192,5192,0,5192,5192,0,5192,5192,0,5192,5192,0,,,,,,,,NPM #1 SANTA CRUZ
10213019D,TOP OF BUENA VISTA APTS,208,208,0,208,208,0,208,208,0,208,208,0,208,208,0,208,208,0,208,208,0,208,208,0,208,208,0,,,,,,,,NPM #1 SANTA CRUZ
10201035N 7,1967 N. GRAND  (LARRIVAS) LMP,5886863,5757450,-129413,4714436,4950158,235722,4674374,5673531,999157,4489938,4714435,224497,4304383,4702625,398242,4304383,4519602,215219,4151825,4304383,152558,4151825,4151825,0,4260074,4494595,234521,4260074,4260074,0,3980868,4179912,4260074,80162,NPM #1 SANTA CRUZ
10201074 7,MARIPOSA HOTEL,1982957,2043835,60878,1626869,1708212,81343,1785687,1982957,197270,1549399,1626869,77470,1475618,1785687,310069,1475618,1549399,73781,1475618,1475618,0,1767458,1790681,23223,1475618,2453874,978256,1475648,1475618,-30,1475618,1475618,1475618,0,NPM #1 SANTA CRUZ
10213019A,BUENA VISTA HOUSE,243381,243381,0,243381,243381,0,243381,243381,0,243381,243381,0,243381,243381,0,243381,243381,0,243381,243381,0,243381,243381,0,256193,243381,-12812,256193,256193,0,210000,220500,231525,11025,NPM #1 SANTA CRUZ
10526034 5,PATE - 513 VALLE VERDE DR,208874,191710,-17164,181626,190707,9081,177231,208874,31643,172977,181626,8649,164740,177231,12491,164740,172977,8237,160613,164740,4127,157424,160613,3189,157586,157424,-162,160722,157586,-3136,157228,160722,157586,-3136,NPM #1 SANTA CRUZ
10203002C 1,R.O.C.  - 1777 N. FRANK REED RD.,278714,238032,-40682,243231,238032,-5199,237083,278714,41631,231649,243231,11582,220619,237083,16464,220619,231650,11031,216153,220619,4466,211610,216153,4543,207948,211610,3662,207822,207948,126,189255,198718,207948,9230,NPM #1 SANTA CRUZ
10203002H 6,R.O.C.  - 1777 N. FRANK REED RD.,274504,234272,-40232,242122,234272,-7850,,,0,,,0,219612,235054,15442,219612,230593,10981,215104,219612,4508,210786,215104,4318,207665,210786,3121,207589,207665,76,189885,199379,207665,8286,NPM #1 SANTA CRUZ
10203002K,R.O.C. - W PAUL BOND DR,85595,85595,0,85595,85595,0,85595,85595,0,85595,85595,0,85595,85595,0,85595,85595,0,85595,85595,0,85595,85595,0,85595,85595,0,85595,85595,0,85595,85595,85595,0,NPM #1 SANTA CRUZ
10306002A 9,PANOUSOPOULOS SCHOLASTIC CHARITABLE,85000,85000,0,85000,85000,0,85000,85000,0,85000,85000,0,85000,85000,0,85000,85000,0,85000,85000,0,85000,85000,0,85000,85000,0,85000,85000,0,85000,85000,85000,0,NPM #1 SANTA CRUZ
10310024B,LAND -  K RANCH,840,756,-84,840,756,-84,840,840,0,840,840,0,840,840,0,840,840,0,840,840,0,840,840,0,840,840,0,840,840,0,840,840,840,0,NPM #1 SANTA CRUZ
10323265A,MONTE CARLO APTS - 2461 N PLACITA SOCORRO,830650,793323,-37327,597128,626984,29856,568693,830650,261957,568693,597128,28435,568693,568693,0,568693,568693,0,645793,671524,25731,646334,645793,-541,624946,646334,21388,622723,624946,2223,603619,622723,624946,2223,NPM #1 SANTA CRUZ
11338019A,NORAH'S II - 300 OLD TUCSON RD,11043445,10631563,-411882,5410863,5681406,270543,8601703,11043445,2441742,5153203,5410863,257660,4907812,8601703,3693891,4907812,5153203,245391,4907812,4907812,0,8278050,8676402,398352,,,,,,,,,,,NPM #1 SANTA CRUZ
11338019B,NORAH'S II - 300 OLD TUCSON RD,11050706,10638743,-411963,5412832,5683474,270642,8607874,11050706,2442832,5155078,5412832,257754,4909598,8607874,3698276,4909598,5155078,245480,4909598,4909598,0,7549355,7935257,385902,,,,,,,,,,,NPM #1 SANTA CRUZ
10201090,LAS PALMAS II - 2065 N OCEAN GARDEN DR,136125,136125,0,136125,136125,0,136125,136125,0,136125,136125,0,136125,136125,0,136125,136125,0,136125,136125,0,136125,136125,0,,,,,,,,,,,NPM #1 SANTA CRUZ
11338010D,FEDEX 1- LOT,331670,331670,0,331670,331670,0,331670,331670,0,331670,331670,0,331670,331670,0,323203,331670,8467,0,331670,331670,,,,,,,,,,,,,,NPM #1 SANTA CRUZ
11338010E,FEDEX 2 - (SOLD) 03/2023-CHUCHO WAREHOUSE,,,0,5737534,6024411,286877,7046992,8806287,1759295,5737534,6024411,286877,331727,3037195,2705468,323259,2472830,2149571,0,331727,331727,,,,,,,,,,,,,,NPM #1 SANTA CRUZ
10201074B 5,LOMA LINDA MALL LLC,4262537,4064908,-197629,3718055,3903958,185903,,,,,,,3541005,3541005,0,3403190,3541005,137815,,,,4684510,4743374,58864,,,,4609584,,,4234026,4445727,,,LOMA LINDA SANTA CRUZ
10201074C4,DELTA PROP. LLP,2400000,5031557,2631557,2400000,2520000,120000,,,,,,,2469030,2914790,445760,2469030,2592482,123452,,,,3195442,3236104,40662,,,,3367273,,,3098970,3253919,,,LOMA LINDA SANTA CRUZ
10801142C,6910 N. MERCER SPRINGS,830069,925811,95742,656825,689666,32841,775388,830069,54681,625548,656825,31277,658936,775388,116452,595760,625548,29788,567390,595760,28370,566396,567390,994,554827,566396,11569,534305,554827,20522,,500297,525312,25015,NPM #1 PIMA
109311010,6121 N VIA PRESILLA PC/LA PALOMA RIDGES ESTSII,,,0,,,0,766681,931293,164612,552010,579611,27601,612600,766681,154081,607059,637412,30353,,,,,,,,,,,,,,,,,NPM #1 PIMA
108011820,"3700 E. ROSE PEAK PL (P.SEP,'09)",1867082,2036682,169600,1592397,1672017,79620,1581176,1867082,285906,1516569,1592397,75828,1458106,1581176,123070,1444351,1516569,72218,1375572,1444351,68779,1389054,1375572,-13482,1349599,1389054,39455,1360749,1349599,-11150,,1360749,1349599,-11150,NPM #1 PIMA
112021530,TUC HSE. 3654 N. SUNTERRA,374716,386538,11822,283137,297294,14157,312256,374716,62460,269654,283137,13483,274202,312256,38054,256813,256813,0,244584,256813,12229,236179,244584,8405,227695,236179,8484,228718,227695,-1023,227695,228718,227695,-1023,NPM #1 PIMA
304189200,3290 S. CANOA PLAZA,1207608,1207608,0,1033059,1084712,51653,1207608,1207608,0,983866,1033059,49193,1207608,1207608,0,937015,983866,46851,1207735,1207608,-127,1207735,1207735,0,1207735,1207735,0,953475,1207735,254260,,770885,809429,38544,NPM #1 PIMA
30421116B,101 W ESPERANZA BL,303271,564217,260946,227133,238490,11357,303271,303271,0,216317,227133,10816,481630,499869,18239,206016,216317,10301,,,0,,,0,,,0,,,0,,,,0,NPM #1 PIMA
30421116E,99 W ESPERANZA BL,125422,125438,16,125422,125438,16,125422,125422,0,125422,125422,0,206729,206729,0,160588,168617,8029,,,,,,,,,,,,,,,,,NPM #1 PIMA
30421116K,115 W ESPERANZA BL,1389643,2290495,900852,1384972,1454221,69249,1389643,1389643,0,1319021,1384972,65951,2290495,2290495,0,1256210,1319021,62811,,,0,,,0,,,0,,,0,,,,0,NPM #1 PIMA
30421116L,69 W ESPERANZA BL,35296,63050,27754,35296,37061,1765,35296,35296,0,35296,35296,0,57886,59051,1165,46429,48750,2321,,,0,,,0,,,0,,,0,227695,,,0,NPM #1 PIMA
30421116M,1610 - BANK,85803,162749,76946,73269,76932,3663,85803,85803,0,69780,73269,3489,135814,141426,5612,66457,69780,3323,,,0,,,0,,,0,,,0,227696,,,0,NPM #1 PIMA
30421119B,191 W. ESPERANZA BL,496566,792770,296204,496566,521394,24828,496566,496566,0,496566,496566,0,686606,773967,87361,489465,513938,24473,,,0,,,0,,,0,,,0,227697,,,0,NPM #1 PIMA
30421119G,121 W. ESPERANZA BL,1309380,2158200,848820,688586,723015,34429,1309380,1309380,0,655796,688586,32790,2158200,2158200,0,624568,655796,31228,,,0,,,0,,,0,,,0,227698,,,0,NPM #1 PIMA
30421119J,101 S LA CANADA DR,643794,1061140,417346,470623,494154,23531,643794,643794,0,448212,470623,22411,1061140,1061140,0,426869,448212,21343,,,0,,,0,,,0,,,0,227699,,,0,NPM #1 PIMA
30421119M,ESPERANZA FRONTAGE,3769340,6257360,2488020,3769340,3957807,188467,3769340,3769340,0,3769340,3769340,0,6257360,6257360,0,3632508,3814133,181625,,,0,,,0,,,0,,,0,227700,,,0,NPM #1 PIMA
30421119P,255 W ESPERANZA BL,189829,322846,133017,189829,199320,9491,189829,189829,0,189829,189829,0,266020,312887,46867,266020,279321,13301,,,0,,,0,,,0,,,0,227701,,,0,NPM #1 PIMA
304211180,249 W ESPERANZA BL,464623,765820,301197,336839,353681,16842,464623,464623,0,320799,336839,16040,765820,765820,0,305523,320799,15276,,,0,,,0,,,0,,,0,227702,,,0,NPM #1 PIMA
304211170,231 W ESPERANZA BL,537033,885170,348137,518744,544681,25937,537033,537033,0,494042,518744,24702,885170,885170,0,470516,494042,23526,,,0,,,0,,,0,,,0,227703,,,0,NPM #1 PIMA
K3353-00-000-0012-00,9901 PHARR LLC,,,,0,,,0,2679928,3193213,0,3193213,,,,,,,,,,,,,,,,,,,,,,,,PHARR HIDALGO
K2400-00-000-0382-10,E MILITARY WAY LLC,,,,,,,,,,,,,,,,,,,,,,,,,,,,,,,,,,,PHARR HIDALGO
